.:,.:,.:,.:,.:,.:,.:,.:,.:,.:,.:
.:,c:0,.:,.:,.:,.:,.:,.:,.:,v:,.:
s:,.:,.:,.:,.:,.:,v:,.:,.:,.:,.:
s:,s:,s:,s:,s:,s:,s:,s:,s:,s:,s:
s:,s:,s:,s:,s:,s:,s:,s:,s:,s:,s:
.:,.:,v:,.:,.:,.:,.:,.:,.:,.:,.:
.:,.:,.:,.:,.:,.:,v:,.:,.:,v:,.:
.:,.:,.:,.:,.:,.:,.:,.:,.:,.:,.:
.:,.:,.:,.:,.:,.:,.:,.:,.:,.:,.:
.:,.:,.:,.:,.:,.:,.:,.:,.:,.:,.:
.:,.:,.:,.:,.:,.:,.:,.:,.:,.:,.: