.:,.:,.:,.:,.:,.:,.:,.:
.:,.:,c:0,.:,.:,.:,.:,.:
.:,.:,.:,.:,.:,.:,.:,.:
.:,.:,.:,.:,v:,.:,.:,.:
.:,.:,.:,.:,.:,.:,.:,.:
.:,.:,.:,.:,.:,.:,v:,.:
.:,.:,.:,c:1,.:,.:,.:,.:
.:,.:,.:,.:,.:,.:,.:,.: